B B B B B B B B B B 
B . . . . . . . . B 
B . B B B B B B . B 
B . B . S 0 1 B . B 
B . B . B B 2 B . B 
B . B . B B 3 B . B 
B . B B G 5 4 B . B 
B . B B B B B B . B 
B . . . . . . . B B 
B B B B B B B B B B 
