. . . . . . . . . . . . . . . . . . . . . . . . . . . . . B B B B B B B B B B B B B B B B B B B B B 
. . . . . . . . . . . . . . . . . . . . . . . . . . . . . . . . . . . . . . . . . . . . . . . . . . 
. . . . . . . . . . . . . . . . . B . . . . . . . . . . . B . . . . . . . . . . . . . . . . . . . . 
. . . B . . . . . . . . . . . . . . . . . . . . . . . . . . . . . . . . . . . . . . . . . . . . . . 
. . . . . . . . . . . . . . . . . . . . . . . . . . . . . . . . . . . . . . . . . . . . . . . . . . 
. . . . . . . . . . . B . . . . . . . . . . . . . . . . . . . . . . . . . . . . . . . . . . . . . . 
. . . . . . . . . . . . . . . . . . . . . . . . . . . . . . . . . . . . . . . . . B . . . . . . . . 
. . . . . . . . . . . . . . . . . . . . . . . . . . . . . . . . . . . . . . . . . . . . . . . . . . 
. . . . . . . . . . . . . . . . . . . . . . . . . . . . . . . . . . . . . . . . . . . . . . . . . . 
. . . . . . . . . . . . . . . . . . . . . . . . . . . . . . . . . . . . . . . . . . . . . . . . . . 
. . . . . . B . . . . . . . . . . . . . . . . . . . . . . . . . . . . . . . . . . . . . . . . . . . 
. . . . . . . . . . . . . . . . . . . . . . . . . . . . . . . . . . . . . . . . . . . . B . . . . . 
. . . . . . . . . . . . . . . . . . . . . . . . . . . . . . . . . . . . . . . . . . . . . . . . . . 
. . . . . . . . . . . . . . . . . . . . . . . . . . . . . . . . . . . . . . . . . . . . . . . . . . 
. . . . . . B . . . . . . . . . . . . . . . . . . . . . . . . . . . . . . . . . . . . . . . . . . . 
. . . . . . . . . . . . . . . . . . . . . . . . . . . . . . . . . . . . . . . . . . . . . . . . . . 
. . . . . . . . . . . . . . . . . . . . . . . . . . . . . . . . . . . . . . . B . . . . . . . . . . 
. . . . . . . . . . . . . B . . . . . . . . . . . . . . . . . . . . . . . . . . . . . . . . . . . . 
. . . . . . . . . . . . . . . . . . . . . . . . . . . . . . . . . . . . . . . . . . . . . . . . . . 
. . . . . . . . . . . . . . . . . . . . . . . . . . . . . . . . . . . . . . . . . . . . . . . . . . 
. . . . . . . . . . . . . . . . . . . . . . . . . . B B B B . B B B . . . . . B . . . . . . . . . . 
. . . . . . . . . . . . . . . . . . . . . . . . . . B . . . . . . B . . . . . . . . . . . . . . . . 
. . . . . . . . . . . . . . . . . . . . . . . . . . B . . . . . . B . . . . . . . . . . . . . . . . 
. . . . . . . . . . . . . . B . . . . . . . . . . . B . . B . . . B . . . . . . . . . . . . . . . . 
. . . . . . . . . . . . . . . . . . . . . G . . . . B . . . . . . B . . . . . . . . . . . . . . . . 
. . . . . . . . . . . . . . . . . . . . 9 . . . . . B . . . . . . B . . . . . . . . . . . . . . . . 
. . . . . . . . . . . . . . . . . . . 8 . . . . . . B B B B B B B B . . . . . . . . . . . . . . . . 
. . . . . . . . . . . . . . . . . . 7 . . . . . . . . . . . . . . . . . . . . . . . . . . . . . . . 
. . . . . . . . . . . . . . . . . . 6 . . . . . . . . . . . . . . . . . . . . . . . . . . . . . . . 
. . . B . . . . . . . . . . . . . . 5 . . . . . . . . . . . . . . . . . . . . . . B . . . . . . . . 
. . . . . . . . . . . . . . . . . . 4 . . . . . . . . . . . . . . . . . . . . . . . . . . . . . . . 
. . . . . . . . . . . . . . . . . . 3 . . . . . . . . . . . . . . . . . . . . . . . . . . . . . . . 
. . . . . . . . . . . . . . . . . . 2 . . . . . . . . . . . . . . . . . . . . . . . . . . . . . . . 
. . . . . . . . . . . . . . . . . . 1 . . . . . . . . . . . . . . . . . . . . . . . . . . . . . . . 
. . . . . B . . . . . . . . . . . B 0 . . B . . . . . . . . . . . . . . . . . . . . . . . . . . . . 
. . . . . . . . . . . . . . . . . . 9 . . . . . . . . . . . . . B . . . . . . . . . . . . . . . . . 
. . . . . . . . . . . . . . . . . . 8 . . . . . . . . . . . . . . . . . . . . . . . . . . . . . . . 
. . . . . . . . . . . . . . . . . . 7 B B B B B B B B B B B B B . . . . . . . . . . . . . . . . . . 
. . . . . . . . . . . . . . . . . . 6 5 4 3 2 1 0 S . . . . . . . . . . . . . . . . . . . . . . . . 
. . . . . . . . . . . . . . B . . . . . . . . . . . . . . . . . . . . . . . . . . . . . . . . . . . 
