B . . . . . . . B . . . . . B 
. . . . . . . . . . . . . . . 
. . . . . . . . . . . . . . . 
. . . . . . . . . . . . . . . 
. . . . . . . . . . . . . . . 
. . . . . . . . . . . . . . . 
. . . B . . . . . . . . . . . 
. . . . . . . . . . . . . . . 
. B B B B B B . . . . . . . . 
. . . . . . B . . G S . . . . 
. . . . . . B . . . . . . . . 
. . . . . . B . . . . . . . . 
. . . . . . B . . . B . . . . 
. . . . . . . . . . . . . . . 
. . . . . . . . . . . . . . . 
. B . . . . . . . . . . . . . 
. . . . . . . . . . . . . . . 
. . . . . . . . . . . . . . . 
. . . . . . . . . . . . . . . 
B . . . . . . . . . . . B . B 
