B . . . . . . . B . . . . . B 
. . . . . . . . . . . . . . . 
. . . . . . . . . . . . . . . 
. . . . . . . . . . . . . . . 
. . . . . . . . . . . . . . . 
. . . . . . . . . . . . . . . 
. . . B . . . . . . . . . . . 
. . . . . . . . . . . . . . . 
. B B B B B B . . . . . . . . 
. . . . . . B . . . . . . . . 
. S 0 . . . B . . G . . . . . 
. . . 1 . . B . 7 . . . . . . 
. . . . 2 . B 6 . . B . . . . 
. . . . . 3 4 5 . . . . . . . 
. . . . . . . . . . . . . . . 
. B . . . . . . . . . . . . . 
. . . . . . . . . . . . . . . 
. . . . . . . . . . . . . . . 
. . . . . . . . . . . . . . . 
B . . . . . . . . . . . B . B 
