B B B B B B B B B B 
B 2 1 0 S . . . . B 
B 3 B B B B B B . B 
B 4 B . . . . B . B 
B 5 B . B B . B . B 
B 6 B . B B . B . B 
B 7 B B . . . B . B 
B 8 B B B B B B . B 
B 9 0 1 G . . . B B 
B B B B B B B B B B 
